Information:
 name:    Test Map
 creator: Mohammad El-Abid
 email:   mohammad@el-abid.com

Tileset:
 file: tiles.bmp
 width: 80
 height: 80
 sprites: 12
 tiles: 192

Tiles:
 00: rect(0,0,80,80)
 01: rect(0,0,80,80)
 02: rect(0,0,80,80)
 03: NULL
 04: NULL
 05: NULL
 06: NULL
 07: NULL
 08: NULL
 09: NULL
 10: NULL
 11: NULL

Graphics:
 00 00 00 00 00 00 00 00 00 00 00 00 00 00 00 00 00
 00 03 06 09 00 00 03 06 06 06 06 06 06 06 06 09 00
 00 04 07 07 06 06 07 07 08 07 07 07 07 07 07 10 00
 00 04 07 07 07 07 07 11 02 05 07 07 07 07 07 10 00
 00 04 07 07 07 07 11 02 01 02 05 07 07 07 07 10 00
 00 05 08 08 08 11 02 01 02 01 02 05 08 08 08 11 00
 00 00 00 00 00 00 00 00 00 00 00 00 00 00 00 00 00

Old Graphics:
 00 01 02 00 01 02 00 01 02 00 01 02 00 01 02 00 
 01 02 00 01 02 00 01 02 00 01 02 00 01 02 00 01 
 02 00 03 06 06 06 06 06 06 06 06 06 06 05 01 02 
 00 01 04 03 03 03 03 03 03 03 03 03 03 06 02 00 
 01 02 04 04 08 08 08 08 08 08 08 03 03 06 00 01 
 02 00 04 06 00 01 02 00 01 02 00 10 03 06 01 02 
 00 01 04 06 01 03 05 01 02 00 01 10 03 06 02 00 
 01 02 04 06 02 09 07 02 00 01 02 10 03 06 00 01 
 02 00 04 06 00 01 02 00 01 02 00 10 03 06 01 02 
 00 01 04 03 06 06 06 05 02 00 01 09 08 07 02 00 
 01 02 09 08 08 08 08 07 00 01 02 00 01 02 00 01 
 02 00 01 02 00 01 02 00 01 02 00 01 02 00 01 02