Information:
 name:    Revisited
 creator: Mohammad El-Abid
 email:   mohammad@el-abid.com

Tileset:
 file: ../images/sheet0.bmp
 width: 192
 height: 64
 tile_width: 64
 tile_height: 64

Tiles:
 00: NULL
 01: rect(0,0,64,64)
 02: rect(0,0,64,64)

Map:
 02 02 02 02 02 02 02 02 02 02 02 02 02 02 02 02 02 02
 02 00 00 00 00 00 00 00 00 00 00 00 00 00 00 00 00 00
 02 00 00 00 00 00 00 00 00 00 00 00 00 00 00 00 00 00
 01 02 02 02 02 01 00 00 00 01 02 02 02 01 02 02 01 00
 02 00 00 00 00 00 00 00 00 00 00 00 00 01 02 02 02 00
 02 00 00 00 00 00 00 00 00 00 00 00 00 01 02 02 02 00
 01 02 02 02 01 00 00 00 01 02 02 02 01 01 02 02 02 00
 02 00 00 00 00 00 00 00 02 00 00 00 00 01 02 02 02 00
 02 00 00 00 00 00 00 00 02 00 00 00 00 01 02 02 02 00
 02 00 00 00 00 00 00 00 02 00 00 00 00 01 02 02 01 00
 02 02 02 02 02 02 02 02 01 02 02 02 02 01 02 02 02 02

Events:
  